00000000000000000000000000000000000000000000000000000000000000000000000000000000000000000000000000000000000000000000000000000000000000
0                                                                                                                                    0
0                                                                                                                                    0
0                                                                                                                                    0
0                                                                                                                                    0
0                                                                                                                                    0
0                                                                                                                                    0
0                                                                                                                                    0
0                                                                                                                                    0
0                                                                                                                                    0
0                                                                                                                                    0
0                                                                                                                                    0
0                                                                                                                                    0
0                                                                                                                                    0
0                                                                                                                                    0
0                                                                                                                                    0
0                                                                                                                                    0
0                                                                                                                                    0
0                                                                                                                                    0
0                                                                                                                                    0
0                                                                      F                                                             0
0                                                                                                                                    0
0                                                                                                                                    0
0                                                                                                                                    0
0                                                                                                                                    0
0                                                                                                                                    0
0                                                                                                                                    0
0                                                                                                                                    0
0                                                                                                                                    0
0                                                                                                                                    0
0                                                                                                                                    0
0                                                                                                                                    0
0                                                                                                                                    0
0                                                                                                                                    0
0                                                                                                                                    0
0                                                                                                                                    0
0                                                                                                                                    0
0                                                                                                                                    0
0                                                                                                                                    0
0                                                                                                                                    0
0                                                                                                                                    0
0                                                                                                                                    0
0                                                                                                                                    0
0                                                                                                                                    0
0                                                                                                                                    0
0                                                                                                                                    0
0                                                                                                                                    0
0                                                                                                                                    0
0                                                                                                                                    0
0                                                                                                                                    0
0                                                                                                                                    0
0                                                                                                                                    0
0                                                                                                                                    0
0                                                                                                                                    0
00000000000000000000000000000000000000000000000000000000000000000000000000000000000000000000000000000000000000000000000000000000000000